111111111111111111
100000000P00000001
100000000000000001
100000000000000111
1000000000000001E1
111111111111111111
