1111111111111111111111111111
1P0000000000010000E000000001
1000010000000100000000000001
1000010000000000000000C00001
1000000000000000000000000001
1000000001000000000000000001
1111111111111111111111111111
