11111111
1001C001
1P0000E1
11111111
