111111111111111111111111111111
1E000000000000000000000C000001
11100000000011110000C000000001
101000000111111100000000000001
1P0000000000001100000000000001
111111111111111111111111111111
